17,17,17,17,17,17,17,17,17,17,17,17,17,17,17,17,17,17,17,17,
18,0,256,0,0,0,0,0,0,0,0,0,0,0,0,0,0,0,0,17,
18,0,0,0,0,0,0,0,0,0,0,0,0,0,0,0,0,0,0,17,
18,0,0,0,0,0,0,0,0,0,0,0,0,0,0,0,0,0,0,17,
18,0,0,0,0,0,0,0,0,0,0,0,0,0,0,0,0,0,0,17,
18,0,0,0,0,0,0,0,0,0,0,0,0,0,0,0,0,0,0,17,
17,1,1,1,1,0,0,0,0,0,0,0,0,0,0,1,1,1,1,17,
18,0,0,0,0,0,0,0,0,0,0,0,0,0,0,0,0,0,0,17,
18,0,0,0,0,0,0,0,0,0,0,0,0,0,0,0,0,0,0,17,
18,0,0,0,0,0,0,0,0,0,0,0,0,0,0,0,0,0,0,17,
18,0,0,0,0,0,0,0,1,1,1,1,1,2,0,0,0,0,0,17,
18,0,0,0,0,0,0,0,0,17,17,17,18,0,0,0,0,0,0,17,
17,1,1,1,1,1,0,0,0,0,17,17,18,0,0,0,0,0,0,17,
18,0,0,0,0,0,0,0,0,0,0,0,0,0,0,0,0,0,0,17,
18,0,0,0,0,0,0,0,0,0,0,0,0,0,0,0,0,0,0,17,
18,0,0,0,0,0,0,0,0,0,0,0,0,0,0,0,0,0,0,17,
18,0,0,0,0,0,0,1,1,1,1,1,1,0,0,0,0,0,0,17,
17,1,1,2,0,0,0,0,0,0,0,0,0,0,0,0,0,0,1,17,
17,17,17,18,0,0,0,0,0,0,0,0,0,0,0,0,0,1,17,17,
1,1,1,1,1,1,1,1,1,1,1,1,1,1,1,1,1,1,1,1